14 17
xxxxxxxxxxxxxxxxx
x               x
x               x
x            1  x
x               x
x               x
x               x
x               x
x  xxxxxxxxx    x
x          x    x
x  x xxxx  x    x
x  x      0x    x
x  x            x
xxxxxxxxxxxxxxxxx
